WWWWWWWWWWWWWWWWWWWWWWWWW
W       W        W  T   W
W       W        W      W
W  S    W               W
W       W               W
W                W   W  W
W                W   W  W
WWWWWWWWW        W   W  W
W                W   W  W
W                W   W  W
W  WWWWWWWWWWWWWWW   W  W
W           W        W  W
W           W        W  W
W        T           W  W
W                    W EW
WWWWWWWWWWWWWWWWWWWWWWWWW